20 10
####################
####################
##########.#########
##########.#########
##########.#########
#####......#....####
##########.#########
##########.#########
##########.#########
####################
